115,120
2,140
110,97
33,20
115,24
19,6
56,66
75,61
48,132
78,117
0101010111a10111111111111111110011111111111111111111011111111111111111111100111a111111111100011a01111011011111011111111001011111101010111111111011011110111a1111
1111111110a11101011110011111011110111111100101111011110111111101101001111100101a111111111111100a11111111111101111111111011111110111101101110101001101011111a1001
0110110010a01101111001111000110111011111111110011111111101111111110111111111111a111011111111111a11111110110111111111111100011111111111111111111111011101011a1111
0101100001a10011101111111110110011111111110111111111111011110111111011111111001a011101011111110a10101111111010101001111110111111110011011010111111110110001a0111
2101110122a22121012200001110111111011101101011111111101111111000111011111111101a011111111111111a01101111111011011110111101111110110111111101101111111011110a1111
0100101112a10221122222111111111110011100101111101011111111101111111111111110010a100011111111011a11011111111110111011111111111111011001110110111011111011101a1111
0110210221b21111202122000111111111110111111110101011111111011011111101111111111a111101101111111a11100010111110010111111111110011111011010110111111101111111a1101
2111212221a11002102211111110111010100111001111111111111110011111100111111100001a111011111111111a01111100011101110111011111111111111110011111111011110111110a1110
0222201112b10101021020101111111111100111111111101111111111101111111110110111110a111111111111111a11110011111111111110110100111111111011100110111110011011010a1111
2101101212a21120012220101111011111011110111111111111111110010110111101111001111a100111111111111a11110111011111110010111110111110111111111111011111111111111a1111
1222111211a21002020202111010101111001111010111101111011111011111111111110001101a111111111100001a01001110111110101001011101111111101111111011110111111011111a1111
1011112211a11102111101111011011110111111111101011110111111111110111111111111101a101111110111011a11111111111101111111111111111111111011110111110001111111111a1101
2111010112b22112020012110101111111110111111111111011111110011011111111111111111a111111111111010a11011111111111111110111111111011110111010111110110011111101a1110
2021122120b01201000220111101111011111111101111111110011111001111101111110011110a111011111110111a11001111001010001010111101111011111101010111111111111101111a1101
1021221021b00110002011101111100011111110111100101111111010111111100110110011101a011100110111111a11111111101101101011111001111111111010000111011110111101111a1111
0202201012a22002210212111111101110111110111010111110011110111111111011110101111a011111111111010a11101110001111111001101101011100110101111111111011111111110a1111
2211121202b00212122101111011111111111011001101101101001011110111011100111011110a001010111111111a11111111101111011111110011111011111011111111111110010110111a1111
1201222211a21122221200101010101111111110110111111111111011111010111111001000000a000111111101111a10101011110110111010111111010110110111111111101111110110111a1101
0121021011a02102201222212120221112201111111100111000111111110110101111101101111a111011111011001a11111011111110111110111111100011110001110101110111110010101a1111
1222012221b20212110102102201121111221100111111111101111011111111111111111011111a011110111111111a00010101111111110111111101110111111111011011100101111111111a1111
2212122121baababbbbbbbbbaabaababbbaaaaaaaaaaaaaaaaaaaaaaaaaaaaaaaaaaaaa01111111a111111111001110aaaaaaaaaaaaaaaaaaaaa1011111111111111111aaaaaaaaaaaaaaaaaaaaa0011
1212111110102121021112012122222011111011110100111111111111011111111111a11111100a11111101111111100111011101111110110a0111110111111111101a101111100111111101111111
1101010011202221222121011121101202220011111111111111011100101110001111a10111011a11111111111111110111111100101111101a1101110011111101111a111111111111111111011110
2102212101101220111011201112211112111101111110110111101111111010101111a11101101a11111111101111110110011111011101011a1111110111111111111a110101111111111001111010
1222220121022112010222021212100201111011101011100110111101101111111111a11111111a10111111110111110111111011010011111a1111011111001111111a110111110111111111001101
1222211011120212212011202211201120201111110110000111011100110100110110a10011110a11011001111111100110110111100111101a1111111110101111011a101111001011111010111111
1222212221102112211102121011112011220011110111111011111100111111111010a11100111a11101111011111101111011111110010101a1101101111110010110a111010011111111111110111
1110110102122201001211211121201110211011111101111111101111100110011111a10111111a10111111111111111101111111111011101a0111111101110110111a111111111110011111111111
2202002201221101201112212122122220221101010011110110111011001111010111a10111110a11001111111111110111101011011011111a1010100101101101101a100110111110111011111111
2100211102122200110011221021211110001111101111111110110111011110011111a11110111a01111101110111111111111111111111111a0111110111101011111a111110111110111111101111
1001120220222111000200012211021122000100011110101110111010111101111111a11110111a11110111111111111111111110110111000a1110111111011111111a111001111110010111110111
1222021001222022020122211210120112200001111111111111101111111101111111a11010111a11111011111111111100111111111111111a1101110111111111111a110111111111111111110111
0221011222011220100221021211111112011111110110111011001111111111111100a11110010a10100101110111111111011111110011101a0111110010100111010a110010111111101110101101
1202011100120212222021112002010121111011101111111101111110111010111111a11111111a11111111111111011111111111111011111a1101212001010120012b212102012102110111101111
0212120121112102111111100011212002121111111111011001011111111011111111a01001010a11101111011001100110111111111111111a1220212022120022121b120122020102110111000101
1011120000111102112112210202111111110111010011011111111110111111111111a01101111a01111111111111110111001101011110111a1211222111222211222b122212202111111111111110
1111112212012110121221201011001002210111101110111111111011101101111111a11111111a11111001110100011101010110111111001a1202111122112022220b202101212100110110111110
1011021210112001102021121121201201001110010101101111101111101011111111a11111101a10100111110111111111111111111111111a0120112010212211212b122212211211011011101111
1110121200120222010110221221211211111101010010110111111111111111111111a10111001a11111110110111110101110001111111111a1021212112001201221b012012102201111100101110
1000112200211212221120122212222211011111110111110111011100111011111111a11111111a10110101010111101001101111111111111a1011201112222100010a011121021111101111011111
0110101111101122220211022101222110010110011111111110111101101101111011a11111111a11111111110111011111111111011001011aaabbabbaaaabbbaabbba120212020221111101111101
1001022102200121121202101111210112211011111111110012000022220101111112b12122010b12111010111111111011111111111101101012122201111212201211021100212201111110110110
1111121012002111211122201021212221001111111111111111021121212211021202a22112111b01111011111100111011111110111110111111212121112211202212012110112211111111111000
1111011112120021211022222022121202221011111111111112212212112102201212b11122111a11111111111111111101111110111111010112021112202010112212021012121222111111110111
0111101211210021010222222222102002110111111111111111210210101011100222b01122212b20110111111101111111111111011111111102021201211002011202202122122010110110111110
0100120201122102220111120121012112221111011011111000111221211222110010a22011211a22011111111111111111111111010110111111102201102021112011121210200022111110011111
1000112022222021112001011111211111221001101111101011020111201012112112a12010010a12110101101111101000111101111111111112110022111122012102111122121202110101110111
0111112222022021222121211121102220221111111101111111220020202122102121b02200222a22111111111111011111110111111011011111111222102222202022020201122101111111110110
1011122022220122122222022022220101221101000111111111212121200101121101a20111202b22011111111110111010110101110111101111001012001102222221012122111212011100111111
1110111101111111111000010111111100111111011011110111222001121202002101a20111110a21101110111011111111111111111100011111122212201002211220211222012120110110101011
1111111010110111111111111101111111111011111011111011112001102010211222a02221211b22001011011111111000111100110111111110102202212010211201212201222000101011110101
0101111111110110101111111111110110111000001101111011221222020010102012b02220120b12011110001011010111111111011111111111011222200122211201122021222212111110010111
1011101111111111111111110111101111111011111101111101112012102011201202b00010222b02000001111111101111111111010111111012210220212201111102221101221122111111001111
0011100111111101101101111111111111111011101111111100110110121212120200a22101212a22010111001110011111111111110110111100222100211121222122121210112212111111111011
0111110110110111100111111111111110111111110111111112020011121121211221a21222221b22110111110111110011111111101110111111101122111222112011122122021010110110011110
1111111111111011111111111011111111101110101101110111010221020212210122a11212202b12101001110101001111111111111110001012222001202221022222021012110210100010111111
1110110101110111010111111111110111101011011011111100101122211122210110b12211121a11101110010110010000011011101101011111012222222201222211112210121011101101100111
1111100101111001111111111111011111101111111111101111111221102210122221a22122012a21111011111111011111010111110011111111111021222122122111121012122212111111111111
1011111111110111011111111111100001111111110111110112112221012102212212b22011111b02111111111111110001111111111111001112102001211121111110121202021121011110111110
1111111111101001011111011011001111011011011111011101021001122221222001a21121221b02111111111011110111111111101111111101111220000222112101111211022111111100110111
111111111111111101110001101111aaaaaaaaaaaaaaaabbabaabaabbaaabaabaaabbba21020101b0011011111011100101aaaaaaaaaaaaaaaaaaabaababbbbaababaaaababaabbbaaabaaaaaaaaaaaa
111111011110011111111111110100a101110111111111212101122122121210111212100111011a2210111000111101111a010011110101011102012211101220202212211121212220011111101110
111011101111110111011111111111a111111111111110112101011122210021112022112122212b1110111110011101111a111101101111111110202120102001112121120221222102011011001111
101110001101111111111111111111a111111111111111020201101110101111001211102122111a0111011101111000111a012111112021121011211022221021221021122121112202111101111010
111111111111111111110111111011a111111001111111122021220110221222212212122012100b1210011011111111100a112120111212122120201222212121212110111111011101010101010110
111111011111101101111100010111a110111111110110012121222211101221101211101001211a1001100111000111110a111221102122210101221021222221202111100111111111001111100110
101001011111111111101111011100a111001111011011211122122112222121202121222221120b0201011111001111110a012201020021210212012212112112112011011011011110111101111111
101010111001001110111101110111a111100111111101101111212212112002012211112222212b1211111111011110110a110222110222122211110201020022200100111101011011111100111110
111111011110111111011111101110a111111111111111121121201022010111112020002220211a0111111011000111011a000121121011102222020221112221220010101111111111110111110011
111101111101101011111111110111a111111000011000121211112121002211212122121222021b2211111110011101101a010100012012212011021121112122212101101111100110110111111110
111000111110011111110111000111a000011111111111211101122220211212012201122222110a2211110011111111110a112202220201002201212111201101222111111111011101100110111111
111111110011111110111111111111a111101110011010020002101012122221010222212202002b2210101111111111101a111202121122212112002211121111212111111111011111110111011011
101101011011111111101101110111a111111111111101211221222122021222121220111102211a1111110101011111111a111002112201101021122121111211211011110111111111111111111110
011111110011011110111111010111a111111111111101101212001202010110221101122111211a1011011100101001110a111101221212222221200010212101210111110110111111111111111110
111111111110010111111111111110a111110101110111122212211201211020111122111221001a1111011111111111011a011111021122111222222102001212220011111110111111011111011111
111001100101111111011110110111a101111100011010212002222222201220212120111111011a1101111011111110111a110100111210122211212201221021021110111111111110111011111111
110110001011111111111110011011a111011101110011200120212111111021212200122112211a1111111111110111011a110211211210001211220112111222110111110010100111111101111111
010111111111010110111111111111a111111111111011111120222212212211011202122012211a1110011001010101111a100001200002221112002100202012222111111111111101011101111101
110111110011110101111011111111a001111111101011222022221110022121222002101112011a1011100111111111110a111112211000212212201222122112212111110111101111111101110110
111011110011111111111111111111a111100111111111212220102201210222220220201022011a1101111101111101101a002202012202222012111020122100211101111011111111010101101101
111111111111011111111110111101a111110101101111001120201001022101001211201221111a1101010011111111111aaaaabbaabbababaaabbaabbbabbababbaaaaaaaa10111110111111101111
001010111111111011111111011001a011110101111011210211120220021022100022002010111a11111110011101111101012120221222112211112120211122122110111a11111011101111111101
011011111101111111111111010111a110111111111100210212201212212222101212111021011a01110111101110111011112111102011212122111121102221211111111a11111101111111101111
011111111111111100111111010111a110111001111110111110220112222100122012200121111a11111111111110111110111222102102101222211112221122210111110a10110110111111001101
100111011111111111100111101111a000111111111111001022020201211122121110022111111a11001110011001011110110222222201222112012122020012002101011a10110011011111010111
111101111000000011111111111110a001111111101001001010101122022201120022022222011a01111111111011111011112110110110022122100012112002101110111a11101111111111111110
111101100110111111111111001101a111111111010011201102200111102221001222222112211a00101101111111110111110101121111212212220011112122222101111a11111111111011111011
110111011111101111100111111111a111011111111111202211202201122202202112111122011a11111111111010110110011021210121012202212122022020121111110a11111010111111111011
011110111101011110110111111101a101001111101101112202212221110112022112111022110a11110001101011101101012212011121202011221102200112111111111a10110110111001111011
111101001101111011111111111100a111111111101111202122221222100110211222112111211a11011110011110111111112021121112110201020212112222112101101a11101110101110110111
100011111110111111101100101111a111101111001111012210021211201021220012221222011a10111111111111111011111202221101120112112201122022021111110a11111110111111011111
111111101101111111111100111110a111001111011110111110111110111110011101011111110a01001111011011011111110021110021001221121112221100222111011a11111111110111111111
101111110111111111111101111111a110110111101100101111011111101110011101100111111a10111110111111110111110121212102122210211112111101221111010a11101110100101010111
111111011111101011101111111100a011111101011010100111111111111001110111011111111a11110111011111101101111120212101010101001111110121120100101a11111111101101111101
111110110011101111110111100111a101001111110111111111111110101011101111101111110a11101111111110111011111011101111001111101111111111110111110a11111111100110110100
111100111011111111100111111011a011110111111111111111101111101111111111011111111a11021211222101001021122201121021211100111100110111001110111a11011101001101111110
111101111011010111111111011110a111111110010111101001010011110111101111101111101a10111222211012121002211020211202211110111110001111111111111a00111110110111101110
111111101111010110111011010111a111101110111111101100111110111101111101111111010a11101112001110121100110222211122011111011111010111110111111a10010111110101011110
111010101111100011110110111111a111010011111111101011110010011111100101010110101a11111211211111110222022001110221201111111011101111111101011a11011111111110111011
101111111101000101110110111111a111011100111111011110001111111110111101111101010a11220021122201202111110210211112011010111111110111111111101a11100010101110110111
011110101211001112211011102010b022202022111111101011111001110101111111111111101a11221220012011220111112011100120111111111110111011111010001aaaaaaaaaaaaaaaaaaaaa
111011111112120121002220111110a101101112110011011101111101011110110011011111111aaaabbbbaabaaabaaaaabaaaabbaaaaabbaaaaaaaaaaaaaaaaaaaaaaaaaaaaaaaaaaaaaaaaaaaaaaa
111111111222021200010112102021a021211222111111011101111010111101111111110101111111100212221120210120001011112220111101111110111011111111011101011111111111111011
111101110212212221210222021222b022122111111111111110111110010111111001001010100011121122211220222200222022021201100110110100110111100111101011011110110101011010
001100101100210212122211220222a212211101111111101110101101011011011111111101101011212210221221011222110211012012211111011110111111111110111111111111100111111111
101100111010122110122121021122a012012122111111111110101111111110100001001110111111212112111102121102001221120022001111111111011011110111111101110101011101001111
011110101010121112222201122122b201112100101111101111110011111110111101101101111101102102122100021222111022121012110111101001101111101111110010111101111111111111
111000101212100221221210122212b020010211001100111111010111101111111111111111001111100121002020122012220022202111011111111111111111101101101111111111111101111111
101110011012012210210012211112a022111210011101001111111111110111111101111111010111220121002101001021022200211201011111111111111101111101111100100111111111111111
111101111212010101111202021221b010211221111011100111111111101111111111111111110101201201021102101021201021111222211110110111101011111111101111111001110110111011
101111101001102211221122022100b210022222111111111111011101111101101000101111101111022120121022102200011202020122111100111000111110011001101110111111011111110111
111101111201212221210210112111a112012221111111101111101101101111101110110111001111111202120202011122111110011111211110111001111110100101111110111111101111110011
111101111122210120111102212011a211121122111011111001101111111101111111111101011111001121210221210212012102122101011010001110111101111111011110110111111111011111
001101111200210222200012201022b201020202100011001110011111101111101011001011111101011212202212102201210211222002011111110010101111011101111111101011100111110111
101010101221122101220020102122b222212001110110111111011011111101111010100111101100201212112122021102021021221101001101111111001101001110111011001111110011011111
111111111112211102211122210011a212102211101111111111111001111111111111111101111111112221120221112021101112122121211110111011111111111110110011111110110101101011
111111111010212110010121021120a011121221111011111111111111011111111101111011111101122200220102112200222212211202111101111111110101111110111111011101111110101111
110011011112221101211210210202a222102222111110110111001110111111110111101110010011020011211212212222111112212120110010011101000111111100111011111101111101111011
111000111021100221112201100120b022221221110001111111111111110101011011111011110111002111102222220222112210022112111111010111110111110110111111011111111111111111
100011111112222002121021221202b221222221111111101011111111101011011110110110111111021111100102211221021011102112010011101111111111011101111111011110010111011110