118,158
16,25
12,9
1,108
26,79
80,5
63,9
100,142
71,91
97,12
011101101001011111101a111101111111111111011111111110110010111101111111111111111101111010101101011011100101111111111111110a1111111a111111011101011111010101011011
aaaaaaaaaaaaaaaaaaaaaa111110111110111101010111111010101111011011110111010111101111001101110101110110011100001111011110111a1111110a111101110110101111110100111111
00010111111101111101aa010110111110110011111101111110101011111111111101111111110111111111101111111111111111011111110111111a1010101a111011111111111111101111001011
11101111111111110010aa010011111011111111111101111101110011111111111111011111111101101111111111111110111110101111011111111a1111111a111110011111111110011100011111
11110011111110111110aa110111111011011110111111110011011111101111111011110110111011011111110111101101100111111110111111111a1111101a101110011101111110101001111110
11101110111101010111aa111111101111110111101010111100101110111111111111111011101100011011110111111111110110011100111111011a0100001a101111111101110111111111101111
01111110011111101111aa111111111110111101111101011111101111111111110011101111011101110111110111111101101001111010110111111a1010011a111110011111111101111111111111
10111111101111011111aa111001111011111111101110110101110110111111110111011000011111111001000011111110110010111111010111101a1101101a111101111011111110111111011100
11111111011110111110aa111111111111111111011011110111011001110111110111111111100111100101101110100110111101110111011111111a1111011a111111111110111111111001110110
11111010011111001011aa010101101111111101111111101011111011011101111001011101111111101011011110111101111111011111110111111a1101111a111111110111111111011111001111
11110001111101010011aa110111101010110110011111111111011111101111101100001111010011111100101111110111100110111011011110111a0111101a111011101111110101101001111111
11101111110111111101aa011111011111111010101011111111101110110111110110111111111101111111110111111101011111111101001111111a1101111a111101011111111111111111111011
11110111001111111111aa111110111111111110012120012002012220112110222102112110111111111111111111111101111011100111101111110a0010111a111111110100111110111111111101
00111100011111101111aa111110110101110111110121122112122121201111222212221111011111101110001111011111111111110111111110111a0111011a111111111111110111011111111011
11110111111111101100aa010011111110111111011212011222211012101102121112210111111111111001111111111111110101110010111101101a1011100a111111101101101011111110001001
10001101111111111101aa111101010111111111112101022121021222121211011120012001111110111110101111111111111110110111001111111a0111110a101111110110111111111011111110
00111111011111011111aa101111111100011111112221111221010110011211222120211010111110111111111110111101111101111100101011111a1110110a111101111101001001101000011110
01111011101111110111aa011111111110111111112221100212002021122111201220110110111111111100110111111110101111101011111111111a1111111a111001011111100011111111111101
01110101111111101111aa111100101101011110012120111201202222001201101111212111001111101101111101111110111111111111010011010a1011101a010111111011111101101011101010
11111101100111110111aa110111101111111111011212122202202222220100112221121111111100111101111011111011111111111111011111001a1011011a111111110011101111111111101101
01110011111111111111aa0111111111101101111abbaabbaabaaababbbbaa2221220012111011001aaaaaaaaaaaaaaaaaaaaaaaaaaaaaaaaaaaaaaaaa1101111a010110111101111111111111111111
11111111011010100011aa1111111111111111111a0111222120122121112b2122202212211111110a10110011110101110111110011111001111001111011110a111011111111101011111111111100
11111111111111001100aa1111101011111111011a2111000122011021121b1121102202110101111a11111111111010111111011101111100111111110110111a111111111111111111101101101001
11001111101101011111aa1110101111111110101a1111111020012010202a0002212122211111111a11111101111111011111111011111111111110101111111a111110111111100111111110111011
11110111111110111101aa1001111101110111110a0020110122000012211b1110120222211111011a11111111111101111111110110111111111111111110011a111101111110101110000101011101
11101111111101110101aa1111111111101110101a1121211112011201100a2121221110210111111a11101011100111110111010011111111101111011111101a111111110001111101111111011111
11111111101110111111aa1111101110111011101a2122122101220210222b0112212112211011011a11111101110110010111101111001110111111011111000a111010110111110110111101111101
10011110001111111110aa0111010110101011011a1112222121102201110a2000222122011001101a11111101101001101111010001101111111111111000011a010110111101111111110111011111
11011110111111011111aa1110010011111101111a2110210111002121212b1001120112011111111a11111111111111001011111111110111001011011010011a111110111111111111111111011011
11111101111111101111aa1111111111110101111a1211211222012222220a2221102121211000110a01111011110111110001111111100111110011110111111a001111101111100111011010111010
10111111110110111111aa1111000101101111111a2120202221020121200b0212222202210111110a00011011101111111000011111110110011111110011111a011011001111110110111101101001
11010111001100111111aa1100111101001111100a2210122102222012200b1201110212111111110a11011111101101101111101111101110111111110111111a110111010011111001101101110110
11111111111011101101aa1011111111111111011a2212002121222122110a1222212211011011001a11110100111111111111111111111111110010111011011a111000111011001111111111111110
11111110011011111111aa1110111111111111110a2220222112122102122b0212012201010101110a00101111110111101101111111110011001111100101111a010101010111111111011110100111
01111111111100010011aa1111111111011111111a2121122212202111211b2110211200100011001a11111111111100111011110101111111111111101011011a100111111111110011011101101100
01111111101111001111aa1110010111100111111a0021111221221212201b0121002221111011111a00110101111101110101111011111011111111101111111a001111101111111110110111111111
11011111001011111100aa0111111110111111011a0021001122202121120b1121100121111111111a11011111111011111110111111110101111111111110111a101100111111101011111110111110
11101101111111110111aa1111111000111111111a1221212121112221111b2111011020111111111a11111111012112201111212021110001200200122011101a110111000110110001111111111111
11111110101011110011aa0110110111111111111a0222002111211120110b2110212201211110111a11111100110222221102112211222021012120122111111a011111111111110111111111111111
01111101110110011010aa1111011111101110111a0222021122120212022b2202212010211111101a01001111112011211210002220101111001200122101001a111000111011111110100111111101
11001011101110011100aa1111101011111110111a2202222222001212221b2122100111211101111aaaaaaaaaaaaaabbbbbba120120111012201010020110101aaaaaaaaaaaaaaaaaaaaa0110111111
01011111011111111110aa1111101111111001110a0111200121011011211a211112201001011110111111111010012222121b11212211102022221012010101111011010111111111110a1101111111
11111111100101011111aa0110111110111101111a0012021111111220200b102101222121101010111101101110210022112b11221221221101202122111011101111110011111111111a1111001011
11111111111111101011aa1111100011101101011a1111111111111111010a101101110111111111101110001011212220211a02211012201111120212111111111111111101111100111a1101111111
01110110101011111011aa1111101011100101101a0111110111111101011a101011110111001111001011011101220121201b02021222221222121222111101100111101011011111011a0111110111
11111001111111111001aa0101111011111011111a1011101111011111110a111110111011111011110011111101110021220b12202111121022210222210101111110000111111011110a1101011110
11101111111101110110aa1011111111111101011a0011101011111011011a011111111111011111111111111111110221020a21221101121122221122111101000011111101111101111a1011111011
00110111111110111111aa1111000101101111110a1011101111010111111a011111111111001110111111100010222012002a11200220102211111001211110111100011111001011011a0101111011
01111101111110112122aa2012122210121210020a1221110101111111011a110101010101110011111011111011202122210a21020020102200110021101111101111111110101111111a1110111111
10111111101012212101bb2102200020201112002a2111100111011101111a001111110011111111110110111011222102112a11010201210120102212011111011111011101111111111a1101101111
11110011111100022121ab2121002222012222221b2221011111101011111a111111111111110111101111111111222110100a22120121212010000211110110101111011101110010001a1011111101
01110111111111220121ba1221212110022100201b2020111111011111011a111011110111111111101001001111221121002a22021211021021011111211001110110111111111111110a1111111110
10111110110112110121bb1212001211111110020b2001111111111111111a111111011011111101110101101111220221101b21112111122121122020111011011101100011111111111a0110011111
11111001111011121121ab2101100221110121220b1111011111010110111a111011111111001111001011111111121101111a21101222022100111201110111111011101011111011101a1100111111
11110101110100221202aa1211110110020211202a1201110110111111010a111111111011101101111010110111212212121b21112101112122122122111110111111110111111111111a0011111111
11111111110012221021ba0110012010120112021b2111111111000111111a110110111111111111101111111101101220122a21222022111220021111011111111110100000000111111a1110111011
11111110111100102120bb0120212001122201212b1211001111111101111a111111111111111111110111110111212122211b11221202211200211001100110101111110010111110111a1111110101
11110111101111210112ab0100021100122102212b1120111022211112111a111110001100011101101111110011101012122a00221210222220212222111010111111111011100001111a1011110111
11011110111111020100bb2121211112101221210a0011201020111221012a110011101111101111111111110111122220101a20112012221020221220111111100100111111111111011a1111101101
11011111101112212021ba0000222211102101100b1211112111022020200b222212220120221012121212112021220221001a01122002021121122021100101111111001111010111101a0111101111
01111111111111011110aa0011112220212220221a1200012212222012221aabaababababbabbaabababababaaaaaaaaabbaaa0200220abbababbabaaabaaaaaaaaaaaaaaaaaaaaaaaaaaa1100111111
01011111011110122101bb1002202112101121222b1112121202010211022211222212221200121021211211212120112110202011120b21201010211101011111110111111111110101101110101011
10111111111101222121bb1201222202111211120a2121021202200012000211021222112121100111211011211110012222120112111b21110002222101111110111011101111110111011110111111
01111001111010121120aa2001001110101120200b0211112212210212202212011010221221221002110211122102212121200000012b12012002011111111111101111011111111101111111111111
10111100111111101102aa2011100022111122222b1110002011221202200121112102101022111110010121101101101111102111111a200010211baabaaaaaaaaaaaaaaaaaaaaaaaaaaaaaaaaaaaaa
01111011101112102110ab0110222122212211112b1222111221122121211101021022120211222201212021122101110211122211020b211211011b2011111111110111111001111111111011110111
11010111110110101222aa2102112211102211220a2221120121121001022111211021221010120120020202112012211102011001121a221001002a1111101111011011101111111101100111010011
11001110101111121212ba0122100012012212112b1112222210111121122221121200201100202120222112200221210221011111021a210111222b2111110111010111001111101011111101111010
11111111111112122210ab2220110112110022111a0212212101122202120211102221122221111212121212121121220121222101222a122120211a1111111111111111111111111111111101111101
11111111101110121012aa1022020111121211220a2112121211122212211121121001220112120221111110220212202211212011122a222121122a0111110011111101111101011101111101111011
01111111111112101111ab2112020211121120012a2110200011000110102212010202122220100001221100111201210122201221200a110101012b1111111000111011111101110011111100111011
11101110111112120222bb1202211121101022120a2212021121100101221111100212120121011211011201111222120012012202122a222222222a1111111111110111101111110110101110011111
00110101001111211122bb1112120010121200011b0111022000111022222211022222212111120212121211211100200121222222120a211011112a1110011011101011010101111111110111011101
01110111111012212201ba1102200112011211011a0111211212001120212122201222222212201222112221012122211211001012012a011011220a1111111101011110111111111111111111111110
11011110000001212121aa2122200011210002112b1221010211222020102102111020110102112011022011212221110200221210012a221112002b1111011101111101111111111111100001110011
11111111000012210111bb2212122122222121210b0101220211102020110211202101111122011112021202122021012221111212122a000221111b1011111111111011111101111110101111110111
10101111110110010012aa1200211210222112102a0012122122210012121220211112212112020111111020012002221112021211121a020101211b1111111011110011110011101111100011111110
11110011001012100101aa2011210211122102211b1221111100012121110121100002121022221121201122122111122011120021211a211121220b0111111111111101101110110111111111111000
11111101101111112101ab0111022221022022211a1122111222111221102121122111121100121202021001012022210221200000011b120112211b0100010110111111111101100111111111110010
01111111110112011020ab1122210212111122201b0222212201211222112012022111211221110020102200102202120221112122112a221221022a1101110010111001111111010110111111011001
11110111101111111101aaaaaaaaaaabababaababb1111102120020200212202102121121212101212222012221202022011121101010b212212102a1111111001110110011111100111111111111111
10111111111111110111a1011101110120100002121121211022112201210101110202002200012222010220121020200021101111012b202100221a1110111101111011111001110101111000111110
10110011111111011111a1111011012122220100212012111010011212112122012022202022111211002111120100021220111101120a222121221a0111110101111110111111101111001001111111
10111110111111110011a1101111112100002102110210021010001122012110211011101110111101110112102202222112120102111a221210222b0111100011111111111011111111011111101110
10110001011111111110a1111111112222102010121220111112121221012221221211221210221110002111222120211112102221021b202212221baaaaaaaaaaaaaaaaaaaaaaaaaaaaaaaaaaaaaaaa
10111011011011010011a1111011001211110211212111120112200002021221121200122010012202201100212112102121112000102a11200120011111111101011111111111111111101111101111
11111110101011101111a1000111111221211111201011212120220222020122122221212122112001112121102222110201001120112b22022220221111111011111110101110100111111111011111
11111011111111111111a1011110112110112120010202121102111212221111011112120212000111200102110112111221120111110a22122112221111111101111111011111110111111100011111
11111110111111101110a1111111101101111001110111101111111111111121100112212112221201221210222221112021102112212b10121121011011110111101111011111011101111111101111
01110111111011111011a1001010010111110111101101111010011111101120210020102100111112121102022220101200211210110b10112110120111111111111011101111000101001111100100
11101110111011111111a1111110001101111111001111101111111111111010111111011011100111010101102222201202212102112a01112202101011111111111111111011111011111110111011
11111111101111111011a0110111111111101111110110011101111011101111111111101010111011011011112120110011222202112b12211011221110011110101011100111111111111111110111
11101110111101111111a1111011101110111001111111111101110111111110110111111111111111011111011101112020010222110a11112222021111111100111111110111111101110111111110
11111111111010100111a1011111111110111111111100110111111111111111011110111101111111111111111210022021221222122b11222202001111110111101110111111111101010111111001
11101111010000110010a1001111100111110111111011110101111111111111101111110111111111001111121100102222121020121b10112020221111111111011001001101111101111101110111
11111111111110011001a1011111001111111111111111011101111011111111010111111110110010111111012202012102121022221a12120010121111110111010111101111111111111111101111
11011111101111011111a1101110011111101101101110000111111110011101001111111010111111101101100221222111201122022b20121211211001111111111101101111111111111111101011
11111111111101110111a1011011111011110110111111111110111011111110111100011111111101111111111111111110111110011a11011111111110111001111011111010010010101111110011
10011110011011001111a1111111101110111110111111011111110101101110101111111111110011111110010111011111101111111a11101111110111111110111111100111111101110111110011
11111011101111110111a1010101111111111100111111111111111010110111111110111010111101111101111110111100111111110a11111111111011111111111111101001101111111111101101
01011110111111110011a1111010111111111110011001101111111111110111110011111101111110110111111101001011011010111aaaaaaaaaaaaaaaaaaaaaaaaaaaaaaaaaaaaaaaaaaaaaaaaaaa
11111101111011111111aaaaaaaaaaaaaaaaaaaaaaaaaaaaaaaaaaaaaaaaaaaaaaaaaaaaaaaaaaaaaaaaaaaaaaaaaaaaaaaaaaaaaaaaaaaaaaaaaaaaaaaaaaaaaaaaaaaaaaaaaaaaaaaaaaaaaaaaaaaa
1111111111111111011101111111111101111111111010111110111110101111111011110111010111111011111111001111011111110111001111110110111111101100111111111101011011111111
1011100101111010011011101111101111101111110101101000111111111010111111111001011111111101111000011210112112101022002212221212101001010011110111110111111111100101
1101101101111001110101011101011111111110111011110110111010110111111001011111111111111111101110021120202112102212120121210101110111011101111010111111001100111111
1111111111100111101111100111110111011111111111011111111111111110101101111011111111111111001011111222222020111210211112010210101001000111111011111111111111111111
1111111101000110011101111001011111101101011001101011111010111111100011001111111011000011000111122122201121222111222201210201111111111011111111011111111111101111
1111101111001111111111111100111110111110110110111001101110011111111111011111100011111111111111021200111112111121120112020002211001111111111011110011110111010101
1111101111111111001110101111010111101011111101011001011001111111011111010111111111011101111111210112120211022211211210220011111110101101011111101111111111111110
1110101111111111101110101001111111110101011101111110111111011111001110111011101011001010101111022220122110120122110111102111011111011011011111011111111111101111
1111101001110110111110111011100111111111111111111101101111011111110011011110001101011111111111112020202202021121121101211022011111111101111111110111101111111101
1111110111111111101111111110011110111101111111101111101011011010110111111011101101111111111111102102221110121012221111010211211110110001111111111111110111111111
1010111011110011101111111101111111111110100101111101111110100111111001111110111100011111111111221200012001220000121110222020110101101111111111011111111111110111
1101011111111111101000111101011100101101111101111111111101111111111110111011111101111111111111222022211111010211200211121211110110111111111111100011111010101110
1111110111110111000111110101101111111111110111111111111111011001010101111110111111101111111110211211210121121211011022121201110111011011011110111001101110111100
1111111111111001111111101111100110111111111111101111111110100110111101001010111111111101011011210002102121222120000122222110100111111111110111111100011111010111
0011100111111111111101111111101111110111110110011001010010111011111111110010110111110101111111020111122111122221102010121122211001111110111100111111111111010110
0100111110011011111111101010111101011110011111011110011111111111111111111111111111101111010110122220220211012211222020020112111010010011110111111011011111110111
1011111111010111111001111101111110110111010111111111110011101101110111111111111111111111100111212122010222201012220100212120211101111111111110111011011101101111
1011101111011101110011111111011111011101111111111110111111111010111111110111001100111011111110021222121121121221102211122121211011100101101111011100111011111110