6,16
114,89
12,9
1,108
26,79
80,5
63,9
100,142
71,91
97,12
1111001111111111101111000110101111101111111011011111101101001001100111111111011010111111001001111101111111010101010101111110111111101011110011110111111101101101
0111111101011111111101110011110111111111110111001111100111111111111111001110010101010111111011111011111110101101011111001101101101001011011111111110010111111111
1111111110101010011111011001111111110111101101101011111111111100111001111111111111011111110101111111111101110111111110100110111011110101111100111111111111101111
1111101101111111111111011101111101011111011110111111100111111011101111111111111111110110100110110110111101111111001111111111101110101001111101111111111110011101
0111111110010101101111111110011110111101110110101110011111101101111110111110110111111111111111111110101111100011110101111110111100111011110111111011111111111110
1000011111101111111101001110111010110111111111111010111110011111111111101111111110001111011111101111001111111110111111111101111111100110101111110100101111111111
0111111111101101111101111111111011101111111111101111111110011111110110111010111111111111111111011111101011111101110011110011110110111101111111111101100111001110
01111011010111111010111111111111111110111111011111111011110101111111011101011111aaaaaaaaaaaaaaaaaaaaa11111001101111111011101011110110111011101111011011011111111
11001101011111101111111011111111001101111110111111011111111111111100011111011111a1111011101111101001a11111011111011111011111111111011111011010000001010011100111
11110111111011111000101011111111111111111111111111100011111110110111100101110111a1111111111110111111a101111010101111111aaaaaaaaaaaaaaaaaaaaaaaaaaaaaaaaaaaaaaaaa
11111101101111010111101111111111111100001110111111010011110111110110101001110111a1101101110011111111a110111011101111111a0110011111111110101111110111011111111101
00110111111011011101110011111101111110111100111011111101111001011111111101111111a1111111111001111101a101111110111011111a0011101011111111111101111111111011111111
11111110110111011011111101111010111010100110011111111111101110111111111111111011a1111111111110101010a111101010011111111a0001110110011111111111111110111111101111
11111001101111110111101111110110111111111111111110111001110111111111111111111101a1101101111110100110a101111101101111110a1101101001001001111111111101110111111110
01111101111110111110011010111110001101101111111111110111111111100111111111111111a1101111110011011000a011111111101101101a1100111111011111101100101111010111111111
11101110110110011110011101111101101011111111110111111111111111001011111011001001a1110110111111010101a011111101111011111a0111011101111101111111111110101111101111
11011111111111110001110111010111110010110111111111111111001111101111111111111001a1111100011111111111a001111111110111101a1111111011111001011101111111011011111110
10111101111111111111011001111111101110011011011101001111110111111111111110111111a1111010110110111011a111111101011101111a0010111011101100111101011111111101111011
11101100111000010101111111011011111111101111001111011111011110101111111101101111a1111110101001111111a101111111100111111a1111000101111011111010111111101100111101
11110111110101101111011111111111111110011111101110111111101111111111101101101111a0010111111101101110a110111011100111110a1011111100111101010011111111111011100001
01011111100111111010110101101011101111100111110001111010110010111111111111110110a1110011011111111001a101111011111011111a1110000010111111111011101011011110111110
11111001101011101111010111111111111101001000111111100001111111111111101111111110a1111010010111101111a111011111101110111a1111110111111110011111111111111110101111
11110101101110110110110110010110101110111110101001010101011100101101101111110111a0111101111111011111a110111101011001111a0011111101011111101111111001101111011011
11111111110111111111111011011110101111111110110111111101110011011000111111011111a1101011111110110101a101111111011111111a1111100111001101110011110111111110011110
01011011111101110011111011101111111111111001011111111010111010111111000111011011a1111111011101110011a011011111111111111a0010001110111111111111100011111110111111
11100010011111101011101111010101001110111111110111011101011111111011110011111111a0011111111101111011a101111111111111111a0111100111011111110111000101111111111111
11110110101111101111012122012202021211220112222100101111111110110101011111111111a1111101111111010101a111011101111110111a0110011111101111111101111111010110111011
1111111011101101111111120002111202110112aabbabbabbaaaaaaaaaaaaaaaaaaaaaaaaaaaaaaa1111111111010110111a110101111101011111a0011111010011101011101001111011101110101
1111110111110101111200222011221121220120b22111222111111111011010111111011111011110101101110111101110a100111011110111111a0101111001111101101111111111111011101111
1110001110111101111110012120121112001112a10120202111011111110110101011111100110110111101010111110011a101001111101111110aaaaaaaaaaaaaaaaaaaaaaaaaaaaaaaaaaaaaaaaa
1111111111101011110122211122200001122201a12122112211001101111011111011111101111010111110111101101011a11001111111111111111101010111111011111111111110111111111111
1111111110111111111110222011112021101211b02021202011110110111011111111111111111011111011011110111110a01011111110111011111110011111110111011110111111111011111111
1010111110011111101110211111111101112221a20212221201111111101100110001110101111111111001001110011111a10010111110111101101111110111111001111101111111111111110011
1010000001111111110211211221112211021220b01112201010011111110111100101011010111111111110111011110111a11011110111101111111101111000111111001111001111110111111111
1001011111111110101220111220112022020111a20221012010111111110111111111111111011101010111111111111110a11111110101101111011111111111001110111111101101111001011011
1111111111111011111010022011220121222222b11122101211000001011111001111110110101110111010011110110111a10111100101110011111110111011001111110111101101111111111001
0011111101111011100211212021120110101121a12000111211101111001101110101111111111101111111101111011111a11110111111111111101111111101011101111111101111011110111111
1111111111111111111102212211210122221222a12202102211110111101011111011111111111001111011101111111110a01101101110111111011111111111111110011111111000101011010111
1001110011111111111211110211220121002222a11201011100110111011101110110101110110111111111010111101001a10111101111001100111101111111100110101101011111111111101010
1111111111001111111202201112122212021112b02222221211001101111111101111111111011111011111111111101101a11111111111111101aaaaaaaaaaaaaaaaaaaaaaaaaaaaaaaaaaaaaaaaaa
1101111001101111110202100211211001212220b21220210011110111111111011110111111111111111110101111011111a01011101111110101a11011111101111100111011111101011111110111
1011111101111111101220211212110120222222a21021210111110111111101111111111100111111111011110011101011a10111111011101111a11001101111100111111111110101100111111111
0111110002011012211212222112112100222111a10011120110110111101011101101010101111111111111111111100111a11111100111011110a10111111111100011011110111111111111111110
1110111122120010122210210212101122221110a21202002210101011111011110111101111111110111111111111111110a01111111111111101a11111101101010111011111111011011111111111
1111111122021120120111122211111221012122b21211111011101011111111111101011101101011011011000101111111a11100111111110111a10001111011101111111101111010011111111111
1110111102201001212012101111121110100212a12122222111111000101111111111110011111011111111111111111111a10111111011111111a01100111011111111110111111111111111101111
1111110111011110021220220222011200211220b12211201201110101111110011111101011001111111101111111011111a01111011011111010a11111111010111111111111111111001011111101
1101010102212102222020012020220100211212b11112222011111100111111101111111010111111010110111101101111a11111111111111110a11111110011101111111111111110111111011011
1110111120211212221011222102000021122211b11121211211111001111100111101101011011111111111101011101011a11111111010011011a11111110111101110111111110110111111010111
1111111120112021201120011001121222220011a21221212000101011110101111110101101011100111111111101111001a01111101111011111a10111011111111101011110110111001111101111
0110111112122112111220022110220110012101b11122121110111111011111110111111111001001011111111111101111a11111111110111111a11101011110111011111110111101001111110111
1111111120120210212101112202221110221101a22111010211101011101000101111101111100111110111100101011110a10111111111111111a10110001111101011110011001010111101111101
1110111122200201011101110210210222102122b21210111111111110011111111111111110111111111111110101111101a11111111111111111a11111111111110111011010111011111110111011
1111010121010221012112111202111212210021a22111002010011110011101111111111101111000111011011111001011a01110111111010111a11111011101111110111110110011011111111111
1111111122012100220111111100121020011112b21212211111111001111101111101011010011111010110111111010111a01111011111111000a10011111111100111101110110101101111111111
1111111111222110221122002111110211122100a10122202211011111101011100111110110111101111010111010111110a10011100111111010a00101110111110100101111111111010111111111
1011011120222120112122021201212212022210a02220221101101101101011111101111111111101010011111111111110a11011110111101111a11111111011111111101111011111101111111111
1110111022102121101002202100211021202221a11011101111111101111110111111110111111111110001111011011111a11110001001111110a00011110011001110111011111011011101101100
0111011122122202112211202120221211222200a11111101111101111111111101110111111111111001101111111001011a11011111110010011a11101111011111111011101100111111111111101
1111111112112212122211210222222122010011a01100111011110111010101111101111111101111011011011110111111a10111111111110111a11101111111111101111101101110101111111110
0001001222021220122112101121212012121021a01111011101101011111111110110101001110111010111011111110001a11011111101111111a10111101001000101111011001111111111101111
0111022020222200122000112001021001100201a11101111101110111111011111101111101111111011111111111111111a11111111111111111a10111111101001011110111111101101010010110
2212101102122112210211011110100210120111a01011110111111000110111010111111110100111111101111001111111a11111111111111110a11011111111111110111110110111001111100110
2211202101002021122110211102020221220011a11111101111111011111101111111010110110111011111111111111001a11011111111111111a11111010011011111001011011101111101110111
2202222202021102222222102202100202022221a10111111111111110100101110111110111110001110111111111111111a11111111101111111a11001111111110111110010101001101010110111
2211022121210110102211210121202112221111a01110101111111011011011011111011111111111101111101011100110a11111100110111110a11010110101111110101111111011110011011111
2222112011122220212110101112022122222111a01111101111101001110101111101111111001111010101101010111111a11101111001110111a11011111110110110111111111111111001111100
21210122001011021222baabbaaabbabbabaabbaa1111111010111111111aaaaaaaaaaaaaaaaaaaaaaaaaaaaaaaaaaaaaaaaa11111111011110111a11101101011111111010111111001111011110111
01122112202201221121a111021011122112220111111111110110011001a111010110111110111111011111111011011111010101111111011100a11101001111111111110111100011101111111011
22011111012210120022b112021022211211121111100110011101111110a011110111011110111110111110111111110111101111111111011101a11010111001111111111101111101101101100111
21101222201112112001a120222110110121220010111110011010100110a111010111110111011110111111011110101111111101111101110101a01111011111111111111101101111111101101111
00022211021212121010b121221100210222221111111111110111101011a110110111010011111111111111111010111111111111100111100111a11011010000110011011111111111111001111111
21212111011110212222b111110220122121202111011101101111111111a110110111110111111110111111001111011110011101111111111111a10111001110111111111111111111111111011110
21121121112111022212b112220102110110001001111111111111011000a110111110110011110110111110111010111111111101010111001111a11111011101111111111110100111111111011110
21122212210112120001a212202010111111111121121021212112121120b222011120211111011111111111011100001111111111011111111101a11100110111111111011111101110101011111111
21022121012121211211a211112212111111111000201212210201102202a220201110111111111111111110111111110101001011110111111101a11111111101111110111100111011111101011101
21000010111211101122a220220022111111111120210121220202122200b111111120101101111111111101101111101111011110101011100011a00111011110110110111001010110111110111111
22111201012100222001a212221221111111110120110201012221011212a222101012111111111100101111101000111110111110111011111010a01011000110101110111111110110011011011011
20022210221221022210b100101120110111111111121201111211102002a110221112111011111011111111111111111011111111111011011111a01111110111011111101111111111101111101101
11122212102221221120a112121202000021211112122101222202211021b121220121210011111001010011101aaaaaaaaaaaaaaaaaaaaa111110a01100111011111110111001111111011111010111
21100211012002222122b212001211120200110101011201112112222212a120010212111111111111010110011a0111111010111111011a111011a11111111110111111011111111111101111111111
21012112221222020012a211000111201201122011002222220111212102b022111111111111111101111111111a0111111011111111111a011111a01111011101111011110101011111111111101110
11211011222221001012b010011222221222121221102210111020221200b112221201111111001011111001110a1011110111111111111a110111a11111001110111111011111111111111110111101
22022021111210121022b021211111100121222112111122121222212212b112122110211111011101111110010a1111111101111111110a011011a01110011111111110111011111111111101110011
01122110202220011110a022112112101122220221122200211012221211a101121222111111100110101111011a1111111111111001011a011101a10111011111111111101011111010111101111101
11221211122111210202a221111210122221110120211222110202112000a110212011110111101111111011111a1111010111101111111a111100a10110111110011101110101111110111011101011
21201200201122100222b121101210212021212011122021121001111202a112102112111111111011111111110a1110100110011111101a110110a11110111111011110001111111101101101011101
11220121120221010222a010111222202120001010022221222211212121bbaaaaababaaaaaaaaaaa0111010111a0011000111011111111a011111a11111111111111100001111011111110111111111
21021212101212121200a12212120111121201112201111201002010012122110012121111111011a1111000111a0011110111110111111a111111a11101010001011111111001111111111111111111
12211221222221012012b22010111202022112221210102111111121102112211211222111101111a1110111111a1111110111111110111a100101a10111101111001011111111111110111111011110
10021221122212222102b22111111012111122201100211012121022102102001212021111101100a1111011100a1111001011001101111a101101a10111111110101111111110101001101111111110
11101111111111111011a11101102210110102112211011021111222122121110121121011110110a0111111111a1011111110111101000a111101a11100101111101011111011110111101111111111
11111011101111100100a11111101021210211210101121222010221111220222221222110111111a1100111111a1101110111111111111a111011a10111111111001111111111111110111111111111
11111111110110011011a11212120222212020121221202012200021120210222112021111111101a0011100101a1111111000101111111a111111a00111110111111011111110101111101111111011
10110110111100110110a00211111222112122121021211011210221102011101212101101111001a1001111011a1111011111101011110a010111a11110111111111010101001011111111111111011
11011111110011111110a00212212122202121012001221102211020211222122120201101111110a1101111111a1101011111111111100a001111a11111010011110111001101111111110110010011
11101111111110110111a11022202020121121211220121212101112122121212021111111111100b2111212021b2111101122221221021a111111a11111111001110101111100011111110111111101
11111010100100111111a11011222111221002102002202112101211222111222220000100010110a2101112212a1120102221201022211a111111a11111111011111101111111101011101110111111
10101010111111111100a10101011100021212011021121212002202011010112012112111111111a1112000210b1212011221021202111a110111a01111111101011111011111111010111010111111
11101110111100111111a11221202122000011220121212111101212211210121201011110111111b0121211012b1120212221111222002a111110a11111111111111110011001101111111111111010
11111010100111111110a11221111212220212120112220121012212201101121112112001110111b1121121122b2202112101222110201a111101a10011010101111010101111011111111010101111
11001111011100111111a11010212111120112221112221122112012111112121011120111111001a0211122011a0220120101211210020a110111a10111111111111111001111111110101111111111
10110110111111101111a11221121202102012212200212012121211122220222212102111010100a0111101221a2102221012122222210a111101a01110111111111011111000101011011111111111
10010111111110101111a11000120212111122122222011200110222120201111121111111001111a2120200201a1122211021111122222a110000a10111111101111110111111111111110111111101
11111111011111011011a11100210201022110201212220111101120121222111221121111010101a1222002221a0111121210010220221a111101a10011101111111110001111111011111111111111
10111111110110101111a01122220021101200111120121111012212220110100011011101110111b1000222220a0221201220112112222a011101a10110011111111110101101110110111111110011
01110111101111111111a11112212022212221221112212212212111121111111110100001011011a2112212201a2222202201022211222a111111a11011010101111111101010111011111110110011
aaaaaaaaaaaaaaaaaaaaa11022001111210220101012100101211220112110111111111111010111a2021121211b1122022221200112110a111111a11111111111101111111010001110111111010001
11111111111111011111101021120220212012121202220121012012211111111111111011011011b1212011202b0222002211221121021a111111a11111111111111111111111011111101111111110
10111101111111011110110212122021022211220221221120222211101111110110010111011111b0101211212a1022102122122210212a111011a11111111101111111101011111111111110111101
11111101100111111111011101120221210120201112112211211122110111110111111110111011a2222010101a2222022101000212220a111110a11111111111111111011110111011111101111111
11100111111101101011001111011211221100221121122221122122121011111111100111110111b0001122210a0101112021121001021a101110a11111110100111011111111111011111111100110
11111011011111111111101111122222011122101022212210012011201111001111101111110011a1011110112a0211221212121210121a111001a11111110000011111101111111100111101011011
11111101111101011111111011102021112012202122200112011112112110111011100110000111b2201112102a0211221121202200021a111111a11111111101101011111110101010110110111101
10111110111110101101111111122012201221112112121101002012022111111011111110111011b1121110120b1021112212222220020a111010a11111111111111101111110010110011101111111
01101111011111111111110111120000001122010211121122122011210010111101011011110001a2022202220b1212211112210222121a111101a11110111011111111011001111111101110111011
01001111110110010111111111120102211111101212210010122002121001111110111010111001a1110111111a1121221210020120002a011001a11101100111111111101111111110110111100111
01001111111111111110110011111121100020211122122222102122022011110011111101101111a2201212020b2012111111201111200a101111a11111111111111101011011011101110011101111
11011111111111111111011111111112221120121221211111201112110111000011111110101111b1211021122b1102101110010211001a111111a11111100111111101111101111001111101111111
01110110111111110011111101012101112212101102021221112011222010001111111110111111a0012102101b0222220121122011112a111111a11110111110101111011111111101111111100111