61,151
4,18
43,110
30,36
74,151
2,53
36,59
49,100
20,50
62,43
000220202111002222101202210102020010001122212210222212102221111220a2201112121022110121101001111110111111111111011111111001121110020112011121001b1102222020202211
111121112211212122221102112102102222112112221102112100210121221101b0102201222111110112211011111101001111111111111101111100021211211212210112121b0112211122121011
111111222222220101221102021121112221012022021221110022222020210221b1111212101011121221201101111011111111111100001110111101102220222110212100221a1020112100012221
aaaabbaabaabbbbbababaabaaaabaaaababaaabbb2221202200121221021121220b2212021012212100010211111111000011011111111011111111111120121222222111211020b1212001112120122
1102212210212120112112121211221010211022a2211212212112020022120100b0201001110211210220210111111111101111011111011011111110122210110122100102112a2220022210222111
1100011112221102122111012122202211022222a1221212111121211010112122b2221221021100122211201010100101111111111110010111010111020221112121021222100a2210120222022122
1011101221011011001112222021122210202221a1121121221122222211211121b1122010121121212122011111011111101111111111111111101111212012122021110210212b2211112120221112
1101212222222211020111020221010120111012b1211211002020220211102112b2222222121022211210011110111111110010111111111111110111202212112122202221112b1122122210220212
1110120002021222222002222220001212121222b1111201002122200122121011a0222102102120021120110111110111101111100011111111011111211122221220222012110b1012020222100212
0111100221110201012020122111022201021122a0101201112210110202202001b1122220102001122110001111110110101111111111111111110111220011120021002011112b1222022010210222
0100112112201110020102220102112102101020b2121111221221110121122201b1110100211011222212210111100111111100000111011101110011221121212211021211210b1021210200112011
1112112002112112121220121212202022111212a2102222222122111121202102b1200111012102221210111111111111101110111110011011111011211121122201021222101a1021111220212201
1101220111011100200122112212111111212221a2101021202122101011000210b2102110022200010022101111011011011101111001001110100111110111220011202100121a2121212121211211
0110121210221222212211011220222220222110b2020220212211211211111020b1121011120112210212211111111011011111111111110011111111212122010221201112210b2112212121122211
1112211101111211111221102111212110111121b2022112100122112101211212a2211100011120221210011111111111111111011111010111110111221111100200111120121a1200211121221211
1112121220220200020100111221220102121222a1120200222210102200121211b2121111120012202021101111111111111001110111111111001110202101102221002100122a1112221120121121
1011210221121110211111000222120122122020a1112100121112102012221201a2111121210221220011010001110011010111010111111111111111112122201221200120220a1110222122022201
0012120211220121122210211112112021212010a1221222212001200112221212a2202200001220212110111111011111110011101011110011011110122012121111212102111b1210221120112102
1110110212202011212111022201122120212222a2211012222102002022111110a2012022112112120010110011110110011111011111011011110111101212211120021121211a1212220122210011
1102112121021121122211122212201222002122a1201112011221002111201010b2121100211212122222110110111100011111110011000111111111111021120210211221121b0102221012121200
1012122012022210212220212211102022222121b0222201221101212010112211a1021112222120122011211111010111101111010111110111110111100102211211210020011a1101220221210102
1112021200222122012220122121222110022112a2211222201112202212110201b1112212120110120120111111001111010111001110111111111111222222202101122112122a1222202100012021
1111021201121221001210220212011012210120b0201211102120001100010100b0211020121211022221101110111101101111111111111111010101211220211102012111122a1221221112020101
aaabbabaaabbaabbaaabaabaaababbbbaaaababba2201111112020201211120212a0222021111222112101001110111110111111111111111000111111010121211211212112221a1211221112112202
110221212200201221022102120202202102121001222022020221121102210221b2211211202121102212211110111111110111101110111111111111202101021102211112021a1112110000101211
111111212011202202112111122201102201122211001222112110122111111202b1122200212122111021111101010111111100011111101111100111112222221221101100212b0222111110222201
111021001011221221112021112121121212122221212112122110112110111101a1210221212212111111111111101011101100111111111111001011112221102212122112120b2211120120112110
001110211022202120210222212212212222212101212121121201201101211111a2022111211021201021111011111110111102211220202220021011212211122022202002101a1222221022021111
011011211112111212201011221001111122201110221022100111011212011101a0211121101221111222111110111101011210022200022112212222112221111101222021022b2222002121221100
101111202111212111222002211121202110222211001222110211220111110112b2111011111210101221101111111010111210210211221211222201100201222202012221011a2102220222112120
111221001112021122101102002111120202210110020110220112120022102020b2121121112102021220111111011011111120021200111121102222221110021212201202211b2012021011012022
101200221021112111111221220201100201220022022012121022112221212111b2102021012012102122211111111011111111121002221222022211212110100222121111221b2222121112011100
111212210200111200111221121220012020200212201110212211022222011222b1000101201020220110110111111101111202121022121211210211120211121222211201121b0201211222221020
101121001212221201122111101201101021011001221121010021012221122222a1121211222102020121211000111111100011112020010110220212122211211010211110111a0110111210022212
111222201212221222011022210121210021222101212122222001222020121220b1201210221221111112211001111111111112111221210212010111002211112102221221202a0020010212222102
aaaabbbbbabbbaaabbbaa122022200121021122001221222011222111202212020a1111011101111011011111011111100111021222102022222122202112121221122012121212a2022200121221122
01121111212212212021b202202222222122122111121112211211110122201212a0111011101111011101110101111001111111011201201222022112202121102120121002102b2022202222121010
10110200222102211100a011201211111210111211122012110011101210112022a1101001110111111110111110101111111210021021111222011002021212211201220112122b1111222120111121
01002100022110021211a112022022111111212111211222112021102222201110a0111111001110001111111011111111111220110212011012122210120121020021112021221a2011111112022120
01011011012110220211b012202121111200111200222212110021100011122111a0111111011101101111111011101010111120111212101210111201202112102221112111221b1220111122221121
11101220001121221122a1120021222212022122012220bbabaabababaaaaaabbaa0101111101110111111110100110111011111210110112122121210201022022222210211012b2111201212010202
01121120000220121202a1122020110220102210222201a011120020211021101110110011011011101111001111111011111212012120202122202112112022022110021210001a1010212012110201
01122201202202021122b1202020111011101010000200a222112111012220222010111111111111011011111111010111111212220122110222201221011112002021022001201a1201221212001110
11110221111122011012a1202122100221221202221222b022210200001111012211010111111011111111111101011111111022110012121111201021201212221202002111220a2222222220222111
11122111212211012211a0112202012122001110212222b120212210211211220010111110111111010110100111101101111210101012121221212011202021112102101120222a0221001021221221
01112011200220112222b1121112211112021121112221b221102112210221020111111111011111101110111111111111111221002112110022201112100110111120112110022b1121112210222121
11122201012012102212b0221110012022122012122212b022111011222101202011111001110111111010110110101111111220111111022221202112202202012112021121202b0211111121020122
01120022101021222222b1200220221122211000201111b100212120120102011111010110110111111111110111100110100202111111012211211222211012211121201222220a2111121111122001
11112110020122000202b2120211022012022122121202a121201211202220112110111111111011110110100111111100111221121012210122122121220221211221100121210b1010112121110222
11112202111222221100a0201121112221012220122221b210122000100121221211011101111101111111011111011111111122222102212011122112202202101212111122100a2121020002011111
10111111101111110111a1111101011001011000001101a111101111111101111111100011101010011111111100011111101121110112101110110112021022120021102222001b2201120022102222
11110001110000100111a0111111110111111001011111a111111001111111011111111011001100111101011101111100001211011121211010222000112212111212101012121b2112122000022121
01011011011111111111a1111100110111111110101110a111110111101111011111110110111011011111111111111011111121122122102001202221100211112022112222221b0212001110022012
00101111111011101101a1011111111011010111111110a101110110111111011101111100111110010111100111110101011112110202001100102110001120222001110022221b1010120221222021
10000101111010100101a1111111101010100000110101a111111111111111010101101111011011111111111111101011011210201002202122021222122111121221211122200a0222122202220210
11111110111111011111a1111001011111111111111111a110111111110111011111111111011110111111011111111111111112010110012110122210011111102102012020212b1112212221221201
11111101111111101011a0001100001111111111011111a101111111111011111111011100111111111111111011111010110220121012011202121202220221112210201020122b0200210011112010
11110111011110110111a1011111111110100111011111a111111011111111101011012121002022112221022122020211021220111111112202202200222212121221111020002b0222000222012221
11110111111111111101a1111101111011111111111101a111110111111010011001010222120221111122121022211221122210220221101022110110211110112220010212100a0121111101200121
11111101101001011111a1111111111111111111110111a111111110111111101111122100010211210000112121210111111110111221111211220212212121110212210001101b1212022111212220
11110111111101111001a0111111011111111111111110a111101101110101001011112011212221000221100221001121222211211012021201220122102111111200121102211a0021210110101112
11101111011111111111a1101100011111111111111001a010111111111111110110121210222111102212100201112100220122110010102110012221011112121011220202002a1101202101111221
01000111111111111111a1101100111111110111110100a111111111122201012021121212202222222100200120101211211001212211011100211122011210222201201112222a1211111222112221
10111111111001011101a0111110111111001111110111a011110111102112221102022221222022012111022022212112110102112221110212111012220220101222111221011a2012122011101112
01111111001110111001a1111010111100111110111110a011111111102112210120012122121221122121221100111002112021200121020210121211012211011111110202112b2111102101212111
11111111111111110100a1111110101101111111111011a111011111112202111221200112202201012112110210122111002222110102010021121021011001110210211101201a1020000122211210
11101011111011011111a1111011111010111110011111a110111100122012112012001010010212112202112122122222220112122020212121111221022112212221210012200b1112102020222112
11011101101111001111a1111101011111110111010110a111011111121112021221100002021002121211112221012112221121201112222122122021112012121222111112121a1222111022110221
11011111111111001111a1011110111011011111000111a101111111111122212102111011020111010122210210012122022222102220011102120011210002002212220222022b2121211220120212
11011101111100101011a1101110011101011111110111a111111111102222021101222211012122221002221101211121221112221222221122112211202221022001221020022b1222201101221110
01101111011110111111a1011101101111100110111110a101101111101202010121111121202121202222212112221212012022101111021222222112020221220111212211021b1111111211021222
11111100111010111101a0101111101111111011111111a111111111110210210012201201021210121112222221122221102010222110122212221021111111211022121121220b1221012002121010
11100111110110010111a1110111101111110111101010a111111111022000221122211112210211121212202111101101212022102121001112211212011201011121011202210b1012211220011210
01111011110111100110a1010111111110111110111111a100111101111112111112121101221211021122201221121211221212222222222212221110210101100122210110111b2120120221012120
01111110011110110011a1101111110110101101011111a011111001111121222101121120222222022010211210121210120221011211212002022201011111011122221210220a2212220220021002
00001110111111101110a1111111111110110111101111a111101011121222022122001111120002112102012012201001022110102022211122200210112221220222220100000b2011122220120212
11111101111110111110a1111010111011001111111111a110111111112011221121120220202100010120020112012101101221211210211201212011101121111212202002210a1202211220022212
01111100111100011111a1010111011111111101100111a011111001101222112212212001121111122012212112121112222122001122000111011221120121012022210221112a1002102111012222
10111110101010101111a1111011111111111111011111a111111111122122201222101122101022221121221200111110111122001210112012120201121010111121111221102a2100112212212002
00101111111111111111a1110110101011111111111110a100111111022010112220202122121022111212112120111022121212010022111012120001012111022121222020001b0120112222212111
11111111111111101111a1111111111111111101111110a11101111112122121211102121011020112121022122112212111202111bbaaabbaabbaabaabaaaa2122111120010221b1000122122121121
11111111110111011110a1110111101110111111111111a11110111102221011102121102002012211221222211112220111222100a2120121112120111222b1021112220121121b1121210212221210
01111001111101101111a1111110011111111101110111a11011011110221121212102111121110102120112022101210021020011a2211012121112022011a1222101111211211b0121122121212110
01111011101111100110a1111110110111111001111111a00111011111012122220000111002011120121111120122212212202222b1222220012110211112b1111122011221212a2212121211112221
11100111111110011111a1111110111111111110111111a11111011101122112122122221122122220021210002110112021020111a2102212112220111101a1211211112012021a0222220220022212
10110100011111101111a1111110110111111111101100a11110101112112101220021200010122221121121122220022101112210b2220122212011221202b1211101201022211a1212111121111011
11011111110111111111a0110101110111011111100101a11111111111012201211211212211221122021220221200212012221220b1210211120011122212a2222021101111121a2020221010201111
00110111101111111001a1111111011011111111011011a11111111111221211111002100212100021020111222221121221010111b2111201110020012220b1212122022002202a1222222212110122
11100011111001001101a1101101111110101001101111a11111110111211222221021222222012121212222220001120221220121b2221111021221121220a0212222101111101a1220111012012221
11111011010011100111a1011111111111111111111111a11011111110110220202122110202110212202021220022001101222200b2210121121202012200b2010122100102022b0221112221111100
10111111011111110111a1001111010110111101111011a11111111112121221010012210111212222021020212201121122022112a2122220012220111211a0111111010122210b2221211012221111
11110001010111011111a1111001011011111010111110a11110111011220221212212021210121221202122021121121120112102b2111221200002111222b1220112012010222b1221212022122120
11100101110111101111a1111111111110001111111100a11111111111111020012222200222011121120221001111222122122212b1120110102202022102a0111111102221112b1120022212222111
01111101111100111110a0111111101101101111101111a11111111012000212002201110211111122202202101121202122101212a1111222201201111022a0021220011021012a2112221122222211
10000111111011111111a0011111111111101111101101a11111110110211212222111012112101111222110111121122202021121b1112001110121112211b0112012201121112b0021011012210200
aaaaaaaaaaaaaaaaaaaaa0110111111101011100111111a11011100112222102102221210010100212100221120121102001222112b1101220011211122222a0211212210120112a1110100121012010
1110101001111111101001101111111111000111111011a11111101111211200211221112102120211022222120120212210122221b2101122112222120011b2011112102221201a0100012100212122
0011111111110111011011111011111111111110111111a01110111012221211001100110220201122221021220021210202002111a2211110201111121212a1122212100112120b1212202211020210
1111011111111110010111111111111111110101111111a11111111110111010102222012022010021111222112211101120100121b2222210122211002220a1221020120222112b2211212222222011
1111110110111110001110011111110111111111101111a10011111111122212012111101110010010212002211201110102211021b2121212110102121002a2010221100022221a2112221102021021
1101110000111111110011011111011010101110110100aaaaaaaaaaaabbbaaabaaaabbbbbbaababbaaaaabaababbabbbabaaaababb2022111120212021212b2121121211111010a1102212112212222
001101111110101111010010110111111101111111110111111111100120221202220222201021112212101222111120111222210022202212221111012101b2111101112221212b1012011011010210
111101101110011100111011111111101000110111011111101111101012121101201121110212222111102211021102121101122112122122122020222111a1012100200220022a2201021022220220
111111100000110101110111111111011011010111110011111111110221211221122211121221221121122221122211111210122012021100011012122111b1202111012001122a2010012220112120
111111111011110111110011111111011010110101111010110110110202112011120221200020122000120112200221112212122012120122112200011111b1011121221111122a1011222011012122
111110111100111110011101111110111111101111111011011110111111111102211201111220222200111112022122202012121011011021201121212012b2200220021121212a1122211212101012
111110011110111111111111011101111011111100111001110100111121110011222120212112120212112210222211210102112121021120211110011021a2111112010012222b1012122100202210
111101111101111111101101111111110110010000111110111110101211112222101111221022100012210221110220120001222212222121022122010112b2211121212202120a1120221201222211
111110111111111001111010111111011111001101111111111111111121010122100212202110221101221111121110111210010221212101022210021110b2220201121221211b2122122102112022
110111111100111111011011110111101111111101111001110101111012111021210011211221122212020222201220110022102221212122220100011121a2012120210022200a2102222121011020
111111110101111111111011101101111011101111110011110101111121112011020122021122121111212011212202222220111121222002121011200120b1200002111022021a2111012112221220
111011110011111000110011111111110111101111111111111000001221210221200022201120111212021012202120212222211121121210212222012112b1122102110101221b1202212122211202
101011110110111101111011111101011111011111111111111101110101011020112022112020122021112111212110122211222012222121212101111111b1222012202210122b2110122201011111
111110011111011001101101111111000111111110111111011101101011011210020111012002120112200211201102112101202122212202121121211200b2220102112121112a1201010222002021
011111111011101111011011111101111101011011101111011101101111211220222102201121112110012112021011221012202211201221220012212222a0021120012121212b2220101111101020
111011001111110111110001000111111110101111110110111111111221222210200222112012220220220121122122120221220212211120101221021012a2221210012212212b2212212200212210
110011111110011111011001111111010110101111111111111010111222122222101220022221102102001111220212011002112111012001000221020212b2111021001112221b1101021121211111
011111101110000011000110011011010111111110011011111111111202211212211101111202110110121012201022200010102022211202111101012022a1112100110111110a0112210121202021
111100111111110111111101011111111101011111001101011110101200022012120122201201121121100220001111211220211002202011121222011221a2021121211011222a1021122020221220
101111111001000110101111011101111110111111111111110111011201112202012202111121221220112210002210221222222020202212102201220221b2212121011111122a2122121200222102