0,47
40,147
1,48
78,122
110,87
116,142
95,131
92,83
9,77
84,77
1111010111011101a111122112120212111121010122021100102200222112020221221211122212111111122211221102221111021011101101a1011101111110111111111111a11111101111110101
1111111111111110a212111102222012221121012220222111121102212211110111021112111202100121211112221121021011011121111011a1110011111111111101111110a11111111110110011
1111111111011011a212210211210222110211212111101212110002012112222212121202102120220100110110002122122212202110011011a0111101110111111111101101a10111111111011110
1110111111101111a221201210111210121212200211110112122120221122100020211222221122001110202200102221120121211200111111a1111010101111100101111111a11011111111110111
1111010111111011a202122212221202210221211222112120122210022022121120000110111102222011221121011102212112212020101111a1111011111111110111001011a11101010111111011
1111111111011111a221121212102222211122201102211112021012012212112112102122112102102022122122121211121212011211100111a1011110111110111111111101a11101111111101101
1101111110111111a012120010221202100112112021220200101122221202110112121210221202110121112110120212102222011121111111a0011111111101111111111111a10010111111101111
1110111011010011a111122121122112022012022111221112122011100200211021002222202210101121112121210221121102222111001111a1111111110111011110111111a11011111110011111
1111111110011000a200012022021022122012111221212120122011122000122202111222111012122112122120202211111110002121111111a1111111101111111111101111a10010111100110110
1101111010111010a221212022121102210120021111201222021222120111010211210220222111122220110121222201012202222011111111a1111110011111101111011111a01111101111101111
1111101111111111a001101022011002022101110211210202022121221201212101011102001112121220010101122200120112012121110111a1111111010011010100111111a01011111111101110
1111010011111111a021212211211202210211020210001210011211122210110001011222102012022212101002102211212110002121010111a1011111011011111011111111a10111111011001011
0011111111011111a121201221201221222121221010122221011100221222100002220210022012122112210221211021100111002021111111a1001110100010011111111110a11111001011101110
0110110100100111a012122210112220220220112212011121202011221201012111201122212202121121102122112110112222121121111110a1100111111110111111101111a11111111111111100
1101011101011011a022211212222112011000112211222111022102212212111112022121200212210202112202111212212221121011011111a1011011101111111001111111a11111101010111100
1011111111111110a101120002022112111021212122010221011012122200220110110202121110212211011111221121101022022201110010a1011111111111111100111011a01111111100111111
0111101110111111a221211201200121021020110110001122221112112222121222202111121200000021222022021000112120100201111010a1011011111101110101101111a10100111111111011
1101110111100111a221110101202200102202111201001121211122222122002011011121120122200100221111200122122112221011110110a1111111101111111010101110a01100111111100110
1110101001100010a101111002121021101220100102121112210112000111222102022001222212111211010011111211210111110121110111a0100111111111111111111111a11110111101111010
1111110111011001a112112111201212102220102211201211212222210211200121101101001222022020022122222100220121122221110110a1111111010011101011111001a01010111011111111
1101111101111111aabaaabbaabbbababababaabaaaabbaabbabbbbabbbbbabbbbbababaaaabbababaabbbbaaabbababa2102201201111011111a11111aaaaaaaaaaaaaaaaaaaaa11111011111110011
111111111100110111212202210021201102021022210120102122112202221122221212112110012202101101211201b1022111121110111111a11011a1110101111110111110111101110111110111
111011100101101111221200200111011021221010122222011011011111222010212122112212110112021021120211a1201202111120111110a11011a1011111101100101111111101111101011011
110111111010111012112010101111101201220120200021102012211102221122220112122200112211022121110121a2212102020101111010a01111a1111111101101111001111111011111111110
111010110110111101022022122110121212122122121220122210211112121010010111212022012111200010111021a1112211011121111101a11101a1111010111100110111110100111101111111
111111110101011101210221211221012201012122211102222102011012022022011122112101210120110112001112b1021221222211110111a11111a1111101111010111011111101110011111101
111001101111111102122000222200222011110221000020110220011120112102121011210101000120221211012111b2011212120211111011a10101a1000111110111010011111110011111001111
010111111110011110120112001110122102212112021111012212112222110120111111122201222011121012112121b0211112112101111110a10110a0111110111111011110111111110100111111
111111011111110011121101202220011202220212212201000111220221001121212212020111102001200121110210b2111111221100101111a01100a1101111011111011111111011101101011100
101111101101011110212211121211112210200222120112220111110022210000021020201110220202222112222212b1220212212121111111a11111a1101111111111111110111110111011110111
110111111100101112112111120111221201012021202220220221021111022210021111112001112001222210210201b2201121100120001111a11111a1110111110111111101110110111000111111
111101111111111110222200010222220000010112101110101011022012121221121212122212100210212121110001a2120210221111101011a01111a1111101110111111111111111101101110110
010111111111110111222212102222222110110211222121122110222001120102112202112010111222002102121011a0021102222121011111a11111a1111110111101101111001110111111101001
01111100111111110110aaaaaaaaaaaaaaaaaaaaaaaaaabababaabbbabbbaaabbaaaaaabaaababbba222120201001201b2011222021011111011a01111a1011111111101011111111111111111010011
11101111111000011111a01111111110111111111011110222121100120100220122121112111100b101210202011001a2102112002221111101a01011a1111111101111111111110010111000011111
11110111101011111111a11011101111111111111111112012221211212011101221122212220110a110212222100122a2211220212221111111a01101a1100111110001110101111110111111111111
11111111011111111101a10101101111111111111111012212010120011222121212101111001112a220122021221101a0010222201211101111a11110a1110101111100111111011111101100111011
10111111011011011111a11101111011111110011111010122121210121000020020012122020212b120211201122221b0101102222001011111a11101a1101011111111011111111111111111111111
10111111110111111111a11101111111101110111110012210022022012112211221021210222122a022210121221021a2120111121111100101a10111a0111101011111100111110111111111110111
11011011111111111101a11111000111011110111111110021102221120222202221112221211212b210212122221211b1222212111111111111a11101a1010111101111111110010101111111110011
11111101111111111111a11100001100111111101111112022211221111102201110221012101110a120021121211101a2212021012100111011a11111aaaaaaaaaaaaaaaaaaaaa11011010110111110
00110110111011011111a11010101001111010111011101111101100011110101010101101111001a011101111111101a1101101011111111111a1101111010111110111111110a11111111111111100
11111111001011110111a11011110111111111101011011011110111011111111111110111111110a010110110111111a1011010111111011110a1111101111011110111011111a10111101101111110
10110111111111101011a11111111100111101100111111110101111101111101101001101111111a111111110111111a1110110011011110101a0111111111111111011111111a01001011011010111
11011011110111100111a11111111111111110100111111111011101110110011111111011111111a111110010101111a0010011111111101110a0101101111111110111111110a11111011111100111
01111111101111111101a01111011111111111111011101011111110111111111111110111110110a111100111110110a0111111110110111111a1111111011111010101010111a10011011011110101
11111111111101011101a11111111101110100111110111110001110101111111111111110111111a111111001001111a1111011111111110111a0111111110111111111111111a01111111111110100
01110110110111101111a11100111111101111011110111111101110111111111101110011111101a011111011120112b2211021222202221112a1222102011202211121122110a02111211112101111
11111011111101111001a01101111100111110111110111100111100111011110111111101000111a111101111122222a0222121021112112122b1110102112012201212121212a10122211111011001
11111110110100111101a10111001111111111111111101111111110101010110111001111111111a010110111120002b0200110121112201201a1221200011212112111222010b22222010111111110
11101110111111111111a01101111011111011111011101001111010111010101111111110101111a101111111122222b0122221101002012120b0222122221122202020110210a12201202211111010
01110111101011111111a00111011011111001111111011111101111011101101100011111111101a111111111011021a2222211121211222101a1222212001121111201212212a21111121111111111
11111111010110111010a11111111101111111111101111110111111101011111111111010111100a111111111102020b0121122011202011211b0022121101212222221111011b12221120000111101
11100111110011101111a11111111011111100110111111021111222221102021212112202111101b210222110011110a0112012022201002220b2121110200122210112220001b01111011222111111
11111110111010101101a11110010110011101101110012222111012221001111210111200222021b121022122221112a2112121222221020011a1121021222200211200020022b11122222022111111
11111111101111111111a00111011111111111011110112221002222220222201122212221212111a110112010112110b2021222211211200121b0211120221211221211121120a01021121211111111
01111110111110111111a11111101101101111111111102200111121200201220022212212222210b111212120222201b1112212121222021101b1211212102211202001012200b02021220111111111
11011111111111111111a11101111011111011111110112110121111222102011222220021020202b122211011200211b1221022021122011110a1001101011120002102222201b11102222101111111
11111110111111111011a11000110101011111000111110121211121112212102110122202002221b112220220020111a1121122101111210121b2121122220210211222021210b21112022211111111
10111100111111110111a10111110111010111111111112221021220201122112222201101212200a122122220022120b2001221100220111110b2120212221110222110112101a21111011011111111
11111011001111011011a10110111011111001011111111012211122021210110211222212112211a212122201122121aabababbabbabbabbbaaa0200011102112210202201220a02000202210001011
11101100110111011111a11111010111111101110111100002110221120020102212122011012111b2020120111110212222212120122012101221012221210122212010211111b12221112221011111
01100111111111111111a11111001101101110111110112221210011021110111022011201210222a0212012201111212221010111012211211221111212122211112010012110a10110222201111100
11110111010001111000a01111011100100101010001112111101122112221201121202210121222a2121202112222122202102121022121121222112220121201121221112112b21112202100011101
11111111111011101111a11111111111110010101000002101112201111212100220212122021212b2200110120120021220111212121211211221020211222212001121221121b01112122211120020
11110110101110111011a11100111111011110111111111202212110212112021112211211122220a2112121222201212121111220111221120221111102012020120122122221b12222211211112100
11111111110111111111a11011111101111011101010101202011011111210222122122101101111b2201021220021111012101021121222212201021111002112220211212120b21201122022202120
11010011111111111111a10010110111101111110110111201022120010211220120212112021122a1022120100202211211122121020122222200010111100000112012101222a10021021012122122
10111011110111111010a11101100111110111011111112211121221211022112020202112011200b2201112220122111002102101110222201210001202021110011021222202b21102200122211110
10111111110010101010a11110101001011010011111012021022100112112212001000221011210b2211122222022222110110111212112121022110221012100211212011210a22212102212012022
11011111111111111110a11111111111111011111111111102111202111222122101102211212101a2221120022221000210010200212000211210211222220102112211112101a22022012110122211
01101101110111101011a11101010011111100101011112222111121221222000222201111122011b2100010212220110112220120012101121202121210102212101002210122a21212121001200011
10001101101101110111a00111011101101001111111111011121121211100210120112010212110a0220212022110200120201112221111221121001122120221200012111200a21111111221211220
aaaaaaaaaaaaaaaaaaaaa11111101110111111011110101020201222021122202011210121212212a1121110101002021012102211201200121122120220212112021112212212b00111111211211210
01101111111111101011111011111111101101101111012221210001002002221011122020122222b1221122222220102120112122012202120102112100001212122221111122a02012012012112020
11111110110011110111111110111110110110111111111200001121212102201210021001111202a1121001102121011200002121212122211202212122202201112022011220b00021210111212121
11001001101111110101011011111011111110011101112211121212120022220002111222120200b1012111222101210110211101112121020122211120212100002122122020a00111221210220102
10011111111111010111101011110111111010110111102012100112110222210122110222021121b2020112122001101211212212221211221122011200212212212221122100a21122012112212111
11011111111111111101001110110111111101111101112212012222222100210012122022200122b2220222101011212222012021021010000021102200122012222202100200b10221120111222221
11111101111101110111111101111111111111100111100222000220102211211222210021001222b2222122212211111220112210211202121011211220200012222102120121b01211121122121221
10111011110011111111111101111011110001110001112001212201121020200212222211200102a1210122121210000211112121222212212202212222022220122111102110babbbaaababbbbbaaa
11011110110010111101111111111110111111111111112210012102112220122210012111121100b1102121011112012200112202102111121012221211120122012121102202222012211121101001
01010111111110110111110111101111111111101011111211221212110212000211212102122012b1021100022102201122122021102001221212012121212101110012011202212221211200201211
11111110111111111111111001111101111011111110101212221011122022110021121111221211a2022211112122211222101222112112121122221110211212110120020202112211202210122220
01101010111111110111101010111111101111001101111111201212021121101122012222020210b1111122200120210010120211111222122001110202102211201202012110021220001221120122
10001110100110011111111110101111110111101011110211120011211020201121112021112101b2111001212212112221111222011122101012121211110111222221101001100110022111212100
11111110111111111111111110111110111110111111112220000202222212110102220121220001b2020221101011100020020122201220110222002211000221210021202201111011122012002222
11011101011011111110111111010110110010111101111022111220210210122110020220121202b0221222121100201222110121111110120211022211121010122121112021212022200212101221
10011111111111100111111111011001110010011011111111011221221121201212122222222221b1121112020210121001022121100221211110122111112121212221022112211220111221221222
11111111111110111111111011101110111111111110111021021020012222222022121211201221b2122112121122202222001102001022111221112022101000102202111222211202222022002110
11111111110101010111011001101111110111110110112211012201221220120022012111110120a1120212011220220001112102122212211101102111121222112222111100000201111022111122
00011111101010111111111000111111101111111011111210221210222201211211021111211121b2102121110021112012210120201111020021022211211222001100121222020112021201021110
11010101101101111111110101111110100111011110102222212202012010222222101011221222a2112202101121012121012210210202102000212012111122201011210011122102220222200221
11111111101111110100100010011111111111001111011221220212212112110202121022110122bbbaaaaaaababaaaababbbaaababaaabbabbbbbbabaaabaaaabbaabaababbbbbaabaaabaaabbbabb
1111111111111110110110011101111011010111111110120021211112121002112021211020211221102210201121021112120112111120112201120101112020012211122102101111212120010221
1001101101011101111111111001111111111111110100202022201121012112211012210200111011011121122221111002101211201221211001221020220122221011212220200220212012112222
0111010111111111110001101100111111011111110110011211222022222202122200121111220222221011011201020111211221212120211222100101100210002122112102201210102022122000
0010110011011001101101101111111100011011110111100011221201220211002121100212222122121202102212101211100121022112122121221121221112211211202122220122010002221202
1111111011111101010111010101111111111010101111000122022100211221122201101112121010211111121102102011200012111022121011101112002112121222212100112222110001112001
1111001111111111110110011011101011110111111101202201102121011221201102112122222100222210122012222101001200021010100200020111211222220102111112210102112112220112
0001110011111111111111110101110000111111111111222211121120112012110110122111221101112222121121021202222001101121100211101122202111222220121221202011202211110111
1111111010001111111111110111101101001011111111112012121210101101021111201212121222222201122211212221121101211122002101222012202122021122111012122120112122111022
1111111110101111110101100111111101111111111111120212022202220011111122110012202221012011220220021111010011221120112111201220122110100002122212221112210011011002
1011101110111111110111101110001111101111010111111011220102222211102101222221122222200201210220111201222212111201121212111222121022102122011112120222220021112222
1111111111001111111111011111011111111000111111212212111221221022022001220112110220222121120021022222012012110022121221212012102212202201121211202111121200212211
1101011011111011100101101111011111011110110011111211102211012002222022112212021112010202122111111022021211112021210122222222112120221011221101112001101122212122
1011111111011111100010111011111111110111001010021122121201211112211221121012002211101222112202112100112121012012221121120022120201120121221200211121021210222102
0111111111101111111101111110111101111111011111111122021122222001120200010202021211112201222122100222122212121110222020112222212020021111112101201110112212111001
1110111011011101101111111111110111111111011111011201112101101212210121121021012021111221211212021201101112102121020112011122112211112110202122112110110110112002
0101011111101111111111101111111111011101101111111012221111021222001122021110000102022210212220111000220210121112012221200211002120020120021011111212010022120120
1110011111101011010aaaaaaaaaaaaaaaaaaaaaaaaaaabbbaaababbabaabbbbababababbabbbbbabaabaaaaaaabbbbbbbaababababaaabbabbbbbabbbaaabaabbbabbbaabbbbaababbabbaaaaaabbbb
0110111111011111111a01111011111011111111100101220111010211022211101202212021221121212220212110211012221222021212121211212221022111002211112011211121112002222122
1111011010110001101a11110110111111111111101011122111022120222212002111212021211202211012012121222222220101110212122222202221211021021221021012200111221011122110
1101111111111011011a11111111101101111111101111002112222202111011211101012102200022112120200110202112102210211211212010101201201021222221101011202102120122121212
1111110110111010101a10011101111110100101010101022211222220111211220221222110222222222210001202102212202121112111111222122212222202211212122010121211221211112220
1111111011101011110a11111111111011010111110111021011221222122212212111221112212101120022222021102220221202202221111002202212112010011022201122202210220220111202
0110111111101111111a11111111111011111001011111011111011220211220112021110122211222212012110022220012112211121122001111101212120002122011102211101101002022121011
1110011111111111111a11111101111111011111111110011111212201121111121212121012221111120202222220220212111112112000012112210020012222222110121111211112021022100021
1111011111101111111a11011111111111111111111111101111221020222120020211210020002021110122220020211201022211112112100212111200110221222021000201222201012212001210
0111101111111111110a10111011111011110001110110111011110212201021201212220121112112112112220221012211222202220021002111111011201102021022012221020112122002202221